1111111111111111111111111
1P0000000000000000C0000C1
1C00000100111111111111111
11111001000010C0000000001
1E0000010C10000010C000001
1111111111111111111111111
